########################################
#..@...................................#
##########^##############...############
#.......#.....+#..........E............#
#.......#....E.#.......................#
#.......########.......................#
#....##...........###.......#..........#
#.......##...............E........####.#
#.................................^....#
#.###################.............#..+.#
#.................................######
#....#####...#...............#.........#
#........#...........E.................#
#...+....#...................###########
#........#...................^....>....#
########################################