########################################
#..@...................................#
#.......##.............##..............#
#...........................#..........#
#......................................#
#......................................#
#....##...........###.......#..........#
#.......##...............E.............#
#......................................#
#..................##..................#
#.................................#....#
#....##......#...............#.........#
#......................................#
#......................................#
#.................................>....#
########################################